...............
...GG......G...
..GHHG.........
...GG..........
...............
...............
......HHHHHH...
.R.............
..HHHHH........
...............
...............
...............
