...............
.R.............
...HHHHHHHHH...
...H.......H...
...H.......H...
...H.......H...
...HHHHHHHHH...
...............
...............
