................
..HHH...........
..HGH......HHH..
..H.H...HHHHGH..
..H.H.HHHGHH.H..
..H.H.H.H.HH.H..
HHH.HHH.H.HH.HHH
HR.............H
HHHHHHHHHHHHHHHH
................
