...............
.R........H....
...HHHHHHHHHG..
..GH.......HH..
..GH.......HH..
...H.......H...
...HHHHHHHHH...
.....H.H.H.....
...............
